0 0 0 0 0 0 0 0 0 0 0 0 0 0 0 0 0 0 0 0 0 0 9 2
0 0 0 0 0 0 0 0 0 0 0 0 0 0 0 0 0 0 0 0 0 0 9 2
0 0 0 0 0 0 0 0 0 0 0 0 0 0 0 0 0 0 0 0 0 0 9 2
0 0 0 0 0 0 0 0 0 0 0 0 0 0 0 0 0 0 0 0 0 0 9 2
0 0 0 0 0 0 0 0 0 0 0 0 0 0 0 0 0 0 0 0 0 0 9 2
0 0 0 0 0 0 0 0 0 0 0 0 0 0 0 0 0 0 0 0 0 0 9 2
0 0 0 0 0 0 0 0 0 0 0 6 6 6 0 0 0 0 0 0 0 0 9 2
0 0 0 0 0 0 0 0 0 0 9 2 2 2 7 0 0 0 0 0 0 0 9 2
0 0 0 0 0 0 0 0 0 0 9 2 2 2 7 0 0 0 0 0 0 0 9 2
0 0 0 0 0 0 0 0 0 0 9 2 2 2 7 0 0 0 0 0 0 0 9 2
0 0 0 0 0 0 0 0 0 0 0 8 8 8 0 0 0 0 0 0 0 0 9 2
0 0 0 0 0 0 0 0 0 0 0 0 0 0 0 0 0 0 0 0 0 0 9 2 
